XXXXXXXXXXXXXXXXXXXXXXXXXXX
XWWWWWWWWWWWWWWWWWWWWWWWWWX
XWCFVFFVFFFFFWFFFFFVFFFFCWX
XWFWFWWFWWWWFWFWWWWFWWWWFWX
XWAWFWWFWWWWFWFWWWWFWWWWAWX
XWVFVFFVAVFFVFVFFVAVFFFFVWX
XWFWWWWFWFWWWWWWWFWFWWWWFWX
XWFFFFFVWFFFFWFFFFWVFFFFFWX
XWWWWWWFWWWWFWFWWWWFWWWWWWX
XWXXXXWFWCFFVFVFFCWFWXXXXWX
XWXXXXWFWFWWWLWWWFWFWXXXXWX
XWWWWWWFWFW0XXX2WFWFWWWWWWX
XDFFFFFVFVWXXXXXWVFVFFFFFDX
XWWWWWWFWFWXX1XXWFWFWWWWWWX
XWXXXXWFWFWWWWWWWFWFWXXXXWX
XWXXXXWFWFFFVPVFFFWFWXXXXWX
XWWWWWWFWWWWFWFWWWWFWWWWWWX
XWAFFFFVWCFFFWFFFCWVFFFFAWX
XWFWWWWFWFWWWWWWWFWFWWWWFWX
XWVFFFFVAVFFVFVFFVAVFFFFVWX
XWFWWWWFWWWWFWFWWWWFWWWWFWX
XWFWWWWFWWWWFWFWWWWFWWWWFWX
XWCFFFFVFFFFFWFFFFFVFFFFCWX
XWWWWWWWWWWWWWWWWWWWWWWWWWX
XXXXXXXXXXXXXXXXXXXXXXXXXXX